When someone taking the | backpack to the bathroom |  *me: I will kill u
When u know u r | being annoying but dont | know how to stop
*When ur frnd says | he is a pro in Ludo
When ur joke | turns into a lecture
The time u hav | been waiting for your | crushs reply
When ur frnd starts | auto punches
The moment ur gf takes | a lot of tym to reply
The moment ur | frnd uploads trains | on whatsapp
The moment ur | frnd uploads | life-changing quotations
After losing many games | with girls | Google: How to hack ludo?
Frnds planning activities | during lockdown
When ur frnd is | faking a story but | u know the truth
Me sitting idle | *My Dad
When teacher starts | a revision classes
After listening to corona | caller tune for 1 minute
When my mother asks me | to fill the bottles
When ur crush rejects | u and accepts ur | best frnds frnd request
When u r in the final | zone of PubG and | customer care calls u
That moment when u | realize sleeping is the | only best thing u have | done during lockdown
Me wen I click on play | and it is a static picture
Me wen my frnd says | "I have seen things man... | Sick things!"
Wen someone talks | about true love
Wen ur daughter | tells she hates men | nd ur son replies | with 'I love men!'
Wen I hear somone | telling 'Jai Balayya' at | a funeral
Wen u r working FH | and ur boss manages | to get u on zoom
Me looking in the | mirror aftr giving myself | a lockdown haircut
Yay! It is Weekend! | *Oh wait ....  | I’m quarantined
Wen he says data science | is the sexiest job | for the 100th tym
Wen u finally get into | relationship with a girl | but u find out he is ur | frnds fake account
Wen u hide ur age | from ur bf but ur |insta id is cutypie*_1999
Wen ur brother says | he  loves cooking but | in reality he loves | cooking meth
Wen she says she loves | Marvel to impress u then | says Superman is the best
Wen someone writes essay on | grammar and mispell | grammar as grammer
Wen u save patient | but they thank God
Wen ur neighbour asks u | what u do for a living
Wen u eat North-Indian biryani
Wen u see someone using | ur trimmer and he | has no beard
Wen ur Windows OS asks | for a restart update
Wen u are asked to | write a lab observation
Wen the whole world | is trolling corona | *le corona
Your Face while listening | to online classes.
Wen ur college decides | to conduct online exams
Wen u sleep at 6 am |and ur mom wakes |u up at 6:30 am
Wen u hit ur toe|while walking
Wen ur guide doesnt|sign ur  project report
Wen u forget a semicolon |in a code and |it shows 3666 errors
Wen someone asks u |to say disgusting things|becoz u have a |disgusting face
Wen ur roommate| sets continuous alarms |but doesnt wake up