The moment u go fr | record correction
The moment wen u | get caught by HoD while | roaming during class hours
The moment u r asked | to give a seminar
The moment u r late to | class bt u donno the | attendence status
The moment ur dad | sees u with ur lover
The moment u check for|results and ur college |is JNTU affiliated
The moment ur | neighbour gets corona
The moment wen | u go fr a date | without a wallet
The moment wen ur | father gets to know | ur actual result
The moment wen u | get caught while | cheating in an exam
The moment ur | father checks ur phone
The moment ur father | checks ur browser history
Wen my sister calls me | "annaya" instead of "orey"
*le me wen I get caught while | cheating in an exam
Me wen lab-incharge | checks everyones record
*Feeling of a student |who went to US to study| this year
Wen the whole class is | fighting over 5.8 or 5.7 | and you get 119
Wen ur dad is angry nd | u bring washing soda | instead of baking soda
The moment ur dad takes | phone but u forgot | to delete history
The moment wen u get | supply exam hall ticket instead | of regular exam hall ticket
*A dad's reaction wen he sees | his children cursing each other | wid 'tera baap!'
Wen u actually call ur | short frnd short nd | she asks u to apologize
Wen u forget ur | lovers birthday
Wen u flush the toilet | and water starts rising
 Wen u hear:|This is your pilot speaking|I'm working from home today
Wen u realize | nobody will survive corona | except Bunty
Me looking in the mirror | aftr givin myself a | lockdown haircut
Wen govt. lifts the lockdown|but u rmbr that now|u hav to face the exams
Wen u have to write an essay |in 3000 letters but u only|have 26letters on the|keyboard
Wen ur bf likes LordKrishna | but then u realise that | LordKrishna has multiple wives
Wen u are a doctor and |get cancer, but u rmbr that| u skipped that part | in graduation
Wen u hide ur age | from ur bf but ur | Insta Id is *_1999
Wen she says: | Your fear... excites me!
Me wen I think of | going back to work
Wen u hear F.E.A.R | is short for | 'f*ck everything and run!'
Wen she updates a status | on fb saying she loves u | but with 16 others
Wen ur lover gets corona|and u dont. |But ur best frnd does and|u realize SomethingIsFishy
Wen u die of corona | but are reborn in China
Wen she says she loves | playing with 8GB RAM | and ur name is "Ram".
Wen u see ur roommate | using ur trimmer but | he has no beard
Wen u forget ur password | and ur fingerprint | doesn't work
Wen u r having lunch | during the class and | teacher catches you red-handed
Wen you give 1000s of |speeches about social distancing |but become the first person|to be infected with corona
The moment I get to know|we are living in red zone
Me trying to open books|and study something|a day before exams
Wen u write |800 lines of code|and exit without saving
Wen u are asked to|publish a research paper