The moment ur crush |becomes ur lab partner
The moment wen u write |an error free code
The moment u see | ur phone with 100% charge
The moment u grab|the remote first!
The moment u confirm|that exams got postponed
The moment we know | our roommate bought| a bike
The moment ur crush | texts u telling that|she has somthng to tell u
The moment ur ex | texts u first
The moment u realize that|ur crush is ur partner|in a duo
That proud moment when |u r the MVP |of ur squad
The moment u get an | invite for duo | frm ur crush
The moment u finish | giving a seminar
The moment u |get to know there is|chicken for dinner
Wen someone talks | about true love |*you: it exists?
Wen u put just 1 leg|outside of blanket |nd it feels perfect
Wen teacher gives|extra 2 marks | just to pass u
Wen ur crush chats with u|in meme language
Knowing MemeGen | automatically generates | a MeMe for you!!
*Me wen my frnd finally | kills a pro player
That moment wen ur | ex marries an old man
Wen u write 1 good code|*le you: It ain't much|but it is honest work
Wen ur frnd allows u|to finish the pizza
My face wen I show | someone a meme
This is how little kids|stare at u for no reason
Wen ur code compiles|wthout any error | in the first try
Wen ur crush replies | to ur message instantly
Wen ur crush cracks | a bad joke | but u gotta laugh
Maths teacher wen he/she|gets to know that|PT teacher is absent
Closed Instagram. So what now?|*Opens again
Wen u see ur ex |roaming on the road |during lockdown |and u are police
Wen u are tortured by |ur mentor but get to know|his son is ur junior
Wen u can't buy happiness|but u can buy weed
That awesome moment|when u r too happy but|you don't know why|and u dont care
Wen you die before|taking a bath in winter
My happy friday face|looks like this!
I know I know|Iam so freaking adorable|that I instantly|make u happy 
Wen I say agra..|to a friend but get appreciated|by teacher for saying the|correct location of TajMahal
Wen she loves dogs |and ur nickname is puppy
Every mothers reaction|when her child speaks|in English with someone
Me telling my gf that |I love her like I love the|stars in the morning sky
Tell me those |3 magical words|*You: sudo apt update
2020 to me: |You having fun yet?