What?|Is this supposed|to be a meme?
Not sure if I'm | annoyed or amused.
That moment wen u r|playing pubg nd ur frnd|asks u to play Ludo
When u r in the final zone|nd customer care calls u|for recharge services
Wen ur frnd starts | auto punches
Wen ur frnd is | faking a story but | u know the truth
Wen ur crush rejects u|and accepts ur best frnds|frnd request
That moment wen | all ur frnds are in | ace and u still in gold
Oh was that a joke?|Remind me later to laugh=.=
People say I'm a | plagiarist. Their words | not mine
I lost my mood ring | and I donno |how to feel about it.
Give that guy | some weed
If Monday morning | had a face
Wen someone talks | about true love
Moment u make eye contact|with co-worker while|walking down the hall
I suffer with that syndrome|wer my cold expresion|makes me luk lyk | a serial killer
If spoilt milk can|bcome paneer, then u|my frnd, can bcome anythng
Wen ppl make fun of me|for being short
Wen they ask me | why I'm single
Wen some random kid|decides to stare at u|and u r like
Yeah I need u to | go ahead nd |shut the f*ck up
Wen u know u have|no tax cut in ur salary|but u earn 2.4 lpa
Wen u die of corona|and the next day|vaccine is found
I told a girl to text me|when she got home.|She must be homeless
Wen she says she loves | Marvel to impress u then |says Superman is the best
Wen u are a HERB lover|and last night u got sick high
Wen u save a patient|but they thank God
Wen u are a Nepali but|someone called u Chinese
Wen ur Windows OS asks | for a restart update
Wen you give 1000s of|speeches about social distancing |but become the first person|to be infected with corona
Wen the whole world| trolls Corona|*le Corona
In this Dalgona time|be your nimmakay|Improve your immunity!
Wen u only use ur phone| for memes
Wen u order security to|increase AC temp. in an ATM| *le security
That moment wen|u realize they weren't|waving at u
Why r frogs happy?|*Me: Because they eat evrythng|that bugs them
When u listen 2 despacito| for the first time